    #####
   ##   #
   #  @ #
#### # ##
#.    . #
#  ###  #
## $ $ ##
 #    ##
 ###  #
   ####
