####
#  ###
#    #
# $  #
### ###
#     #
#..@  #
#  $  #
###  ##
  ####