####
#  ###
#    #
# $  #
### ###
#     #
#..$  #
#     #
### @##
  ####
